
SO ./textures/north.xpm
NO ./textures/south.xpm
WE ./textures/west.xpm
EA ./textures/east.xpm

C 102,255,255
F 102,255,255
       
1111111111111111111111111111
11110111111111011100000010001
11110111111111011101010010001
11000000110101000000000000001
10000000000000001100000010011
100000000000000001101010010001
11000001110101011111011110N011
11110111 1110101 101111010001
11111111 1111111 111111111111