SO ./textures/north.xpm
NO ./textures/south.xpm
WE ./textures/west.xpm
EA ./textures/east.xpm  

C 1,232,234
F 1,1,1

1111111111111111111111111111
11110111111111011100000010001
11110111111111011101010010001
11000000110101000000000000001
10000000000000001100000010001
1000000000000000110101S010001
1100000111010101111101111000111
11110111 1110101 101111010001
11111111 1111111 111111111111