SO ./textures/north.xpm
NO ./textures/south.xpm
WE ./textures/west.xpm
EA ./textures/east.xpm  

C 1,232,234
F 220,233,1

           1111111111111111111111111
           1000000000110000000000001
           101100000111000000000000111111111111111111111111111111111111
           1001000000000000000000001
111111111111000001110000000000000001
10000000001100000111011111111111111
11110111111111011100000010001
11110111111111011101010010001
11000000110101011100000010001
10000000000000001100000010001
1000000000000000110101N010001
1100000111010101111101111000111
11110111 1110101 101111010001
11111111 1111111 111111111111